NO   ./Pictures/wall_1_grey.xpm
EA   ./Pictures/wall_2_green.xpm
SO   ./Pictures/wall_3_blue.xpm
WE   ./Pictures/wall_4_red.xpm

F    115, 147, 179
C    212,230,241

     1111111111111111111111111111111111111
     1000000011000000000000000000000000001
     100000000000000E0000000000000000000011
     11111111000000000000000000000011111111
1111111000000000000000100000000001000111111
1000000000000000000000000000000000001
1000000000000000000000000000000000001
1000000000000000000000000000000000001
1000000000000000000000000000000000001
1000000000000000000000000000000000001
1000000000000000000000000000000000001
1000000000000000000000000000000000001
1000000000000000000000000000000000001
1000000000000000000000000000000001111
1011000001110000000000000000000100001
1001000000000000000000001111111100001 
1111111110111100011100001110000000001 
1000000000111010011101111 11111100001 
1111111111111111111111111 11111111111
        111111111111111111111      