NO   ./Pictures/wall_1_grey.xpm
EA   ./Pictures/wall_2_green.xpm
SO   ./Pictures/wall_3_blue.xpm
WE   ./Pictures/wall_4_red.xpm


F 91,95,144
C 100,101,20




111111111111111111111111111111111
100000000001000000000001000000001
101100000101000000000001000000001
100100000000000000000001000010001
111111111011000001010000000000001
100000000001000001010111111111111
111101011111111101000000100001001
100001000000000101010100100001001
111101111111110101000000100000001
100000000000000000000000000001001
100000100000000010010100100000001
111110010101010110100111101001001
1000000100010101000100001000010N1
111111111111111111111111111111111